%%%%%%%%%%%%%%%%%%%%%%%%%%%%
%.                .        %
%                          %
%       .   .       .      %
%                  ........%
%.                 ........%
%               . ........ %
%       .   .       .      %
%P       .   .       .     %
%%%%%%%%%%%%%%%%%%%%%%%%%%%%
