%%%%%%%%%%%%%%%%%
%P  .          .%
%%%%%%%%%%%%%%%%%
